NO ./textures/yellowmaze.xpm

SO ./textures/mazeblue.xpm

WE ./textures/mazered.xpm

EA ./textures/greenmaze.xpm




F 151,125,118



C 171,205,239









11111111111111111   11111
10000000000000001   10001
10000000000000001   10001
1000000000000000111110001
1000000000000000000000001
1000000011111110000000001
1000000000000000000000001
1000000000000000000000001
1000000000000000000000001
1000000000000000000000001
1000000000000011111111111
1000000000000000000000001
1111111110000000000000001
1000000000000000000000001
1000000000000111111111111
1000000000000000N00000001
1111111100000000000000001
1000000000000000000000001
1000000000000000000011111
11111000000000000000000011111
    1000000000000000000000001
11111000000000000000000011111
1000000000011111111110001
1000000000011100000000001
1111111111111111111111111