NO ./textures/yellowmaze.xpm

SO ./textures/mazeblue.xpm

WE ./textures/mazered.xpm

EA ./textures/greenmaze.xpm




F 151,125,118


C 171,205,239



        11111111111111111111111111111
        100000000011000000000001111
        101100000111000001100001
        10010000000000001  10001
11111111101100000110000001100001
10000000011000001110111111111111
11110111111111011100000010001
11110111111111011101010010001
11000000110101011100000000001
10000000000000001100001000001
10000000000000001101010001001
1100000111010101110101101000111
11110111 1110101 101111010001
11111111 1111111 11111111111111111