NO ./path_to_the_north_texture

SO ./path_to_the_south_texture

WE ./path_to_the_west_texture

EA ./path_to_the_east_texture






F 220,100,200



C 225,30,0





        111111111111111111111111
        100000000011000000000001
        101100000111000001100001
        10010000000000001  10001
11111111101100000110000001100001
10000000011000001110111111111111
11110111111111011100000010001
11110111111111011101010010001
11000000110101011100000000001
10000000000000001100N00010001
10000000000000001101010010001
1100000111010101110101101000111
11110111 1110101 101111010001
11111111 1111111 111111111111
