NO ./textures/wall.xpm

SO ./textures/redwall.xpm

WE ./textures/bluewall.xpm

EA ./textures/black.xpm




F 151,125,118



C 171,205,239

          1111111111111111111
         100000000000000000001
        10000000000000000000001
       1000000000000000000000001
      100110000011100000110000001
     10000110000011100000110000001
    100001000000000000001  10000001
   111111011000001100000011000000001
  10000000000000111011111111111000001
  11011111111101110000001000000000001
  110111111111011101010010N0000000001
  10000011010101110000000000000000001
  10000000000000110000100000000000001
  10000000000000110101000100000000001
   100011101010111010110100000000001
    100000000101 101111010000000001
     10000000001 10000000000000001
      100000000010000000000000001
       1000000000000000000000001
        10000000000000000000001
         111111111111111111111